11111111111111111111111111111111
10000000000000001E10000000000001
10111101111011101010011110111101
101111C11110111010100111101111C1
10111101111C1110101001111C111101
10111101111011101010011110111101
10000000000000000000000000000001
10000000000000000000000000000001
10000000000000000000000000000001
10111101111011101010011110111101
10111101111C1110101001111C111101
101111C11110111010100111101111C1
10111101111011101010011110111101
10111101111011101010011110111101
101111C11110111010100111101111C1
10000000000000001P10000000000001
11111111111111111111111111111111