11111111111
10000000001
1P0000000C1
1C0000000E1
11111111111

