11111111111111
11111110001111
1000000C001111
11PE1C01001111
11111111111111