11111111111111
11111100001111
1000000C001111
11PE1C00001111
11111111111111