11111111111111
11111101001111
1000001C101111
11PE1C01001111
11111111111111