11111111111111111111111111111111
1E0000000000000C00000C0000000111
10100101001000001010010000000111
10100101001000001010010000000111
10100101001000001010010000000111
1C100100101010100010010000000111
100000P00C00C0000000000000000111
11111111111111111111111111111111